[level]
tileset = pygametileset.bmp

map = ...............
	  XXX...XX..XXXXX
	  ...............
	  ...............
	  ...XXXXXX.XXX..
	  ........X......
	  ........X......
	  ...XXXXXXXXXXXX
	  ...............
	  ...............
	  XXXX....XXXXXXX
	  X..............
	  X..............
	  XX....XXXXXXXXX
	  ...............
	  ...............
	  XXXXXXXX....XXX
	  ...............
	  ...............
	  XXXXXXXXXXXXXXX

[.]
name = floor
tile = 0, 3

[X]
name = wall
wall = true
block = true
